0000000000000000000000000
0101110111001111111111100
0111011101101000000001000
0101000000111111111111100
0101111111100000000000100
0100000010111111111111100
0111111111100010010000100
0010000000100010110100100
0010000111111111100111100
0110011100010010000100100
0010010111110011111100100
0010010000010010000100100
0111111111111111111111100
0000000000000000000000000
