0000000000000000000000000
0111111111111111111111110
0100100100100010010010010
0100100100100010010010010
0100100100100010010010010
0111111111111111111111110
0100100100100010010010010
0100100100100010010010010
0111111111111111111111110
0100100100100010010010010
0100100100100010010010010
0100100100100010010010010
0111111111111111111111110
0000000000000000000000000
