0000101011111111111111000
0111101110010100101001010
0010111010111111111101110
0111101110100100100111000
0100111010101111111101110
0111101110101000010111010
0010111010101111011101110
0111101110111101010111000
0100111010000101011101110
0111101111111101010111010
0010111001001001011101110
0111101111111111010111000
0100100101001010011101110
0000111111111111110101000
