0000000000000000000000000
0111000100011111110001010
0001000111110010000001110
0001000100000010011011010
0111111100010010011010010
0100000111110011111111010
0111111100010000011000010
0000100000111000001001110
0111110000111110001000010
0100010000100010001111110
0100011111100010001000010
0111000010000011111001110
0111000011110000001111010
0000000000000000000000000
