0000000000000000000000000
0110111111111111111111110
0110111111111111111111110
0111100000000011011000000
0111100000000011011000000
0011000000111111011000000
0011000000111111011111110
0011000000110000011111110
0011111111111111011000110
0011111111111111000000110
0000000000000111000000110
0111111111111111111111110
0111111111111111111111110
0000000000000000000000000
